111111111111111111111111111111111111111111111111111111111111111111111111111111
1                                                                            1
1                                                                            1
1                                                                            1
1                                       C                                    1
1                                                                            1
1                            G                                               1
1                         1111111                                            1
1                                                                            1
1                                                                            1
1 C     P        G                                 E                         1
111111111111111111111111111111111111111111111111111111111111111111111111111111
